,,,,,,
品德,英语,品德,体育,英语,,
班队,班队,英语,班队,美术,,
美术,班队,数学,英语,科学,,
,,,,,,
,,,,,,
英语,美术,体育,体育,品德,,
品德,科学,数学,英语,英语,,
体育,语文,体育,科学,语文,,
,,,,,,
,,,,,,
,,,,,,
,,,,,,
